NO ./textures/bluestone.xpm
SO ./textures/colorstone.xpm
SO ./textures/colorstone.xpm
WE ./textures/greystone.xpm
WE ./textures/greystone.xpm
EA   ./textures/redbrick.xpm
EA   ./textures/redbrick.xpm

F 124, 55   , 12
F 124, 55   , 12
F 124, 55   , 12
F 124, 55   , 12

C     12, 220, 125
C     12, 220, 125
C    113 , 220, 125

        1111111111111111111111111
       110000N0000110000000000001	
        1011000001110000000000001
        1001000000000000000000001
11111111101100000111000000000S001
100000000011000001110111111111111
11110111111111011100000000001   
111101111111110111010100100011  
110000001101010111000000100001   
100000000000000011000000100011
100000000000000011010100100001
110000011101010111010111100111
11110111 1110101 10111101011
11111111 1111111 1111111111
