NO ./textures/bluestone.xpm
SO ./textures/colorstone.xpm
WE ./textures/greystone.xpm

EA   ./textures/redbrick.xpm

F 124, 55, 12

C    113 , 220, 125

        1111111111111111111111111
        11111111111111111111111111
       1100000000110000000000000001111111111111	
        101100000111000000000000000000000000011
        100100000000000000000000111111111111111
11111111101100000111000000000S001
100000000011000001110111111111111
11110111111111011100000000001   
111101111111110111010100100011  
110000001101010111000000100001   
100000000000000011000000100011111111111111111111
1000000000000000110101001000011                1  
1100000111010101110101111001111111111111111 
11110111 1110101 10111101011
11111111 1111111 1111111111
