NO                      ./textures/bluestone.xpm
SO ./textures/colorstone.xpm
WE ./textures/greystone.xpm
EA   ./textures/redbrick.xpm

F 124, 55   , 12

C     12, 220, 125

        1111111111111111111111111
        1000000000110000000000001	
        1011000001110000000000001
        1001000000000000000000001
111111111011000001110000000000001
100000000011000001110111111111111
11110111111111011100000000001
111101111111110111010100100011
1100000011010101110000001000001
100000000000000011000000100011
100000000000000011010100100001
11000001110101011111011110N0111
11110111 1110101 101111010001
11111111 1111111 11111111111

