NO ./textures/bluestone.xpm
SO ./textures/colorstone.xpm
WE ./textures/greystone.xpm
EA   ./textures/redbrick.xpm

F 124, 55   , 12

     C     12, 220,    125

1111111111	
1000000001	
1001110001
1001N10001
1001110001
1000000001
1111111111
