
NO ./textures/bluestone.xpm
SO ./textures/colorstone.xpm
WE ./textures/greystone.xpm
EA ./textures/redbrick.xpm

F  117, 142, 79
	C 135, 45, 251

1 1111 11
1111111111
1000000001
1011111001
101   1001
101   1001
101   1001
101   1001
101   1001
101   1001
101   1001
101   1001
101   1001
101   1001
101   1001
101   1001
101   1001
101   1001
101   1001
101   1001
101   1001
101   1001
101   1001
101   1001
101   1001
101   1001
101   1001
101   1001
101   1001
101   1001
101   1001
101   1001
101   1001
101   1001
101   1001
101   1001
101   1001
101   1001
101   1001
101   1001
101   1001
101   1001
101   1001
101   1001
101   1001
101   1001
101   1001
101   1001
101   1001
101   1001
101   1001
101   1001
101   1001
101   1001
101   1001
101   1001
101   1001
101   1001
101   1001
101   1001
101   1001
101   1001
101   1001
101   1001
101   1001
101   1001
101   1001
101   1001
101   1001
101   1001
101   1001
101   1001
101   1001
101   1001
101   1001
101   1001
101   1001
101   1001
101   1001
101   1001
101   1001
101   1001
101   1001
101   1001
101   1001
101   1001
101   1001
101   1001
101   1001
101   1001
101   1001
101   1001
101   1001
101   1001
101   1001
101   1001
101   1001
101   1001
101   1001
101   1001
101   1001
101   1001
101   1001
101   1001
101   1001
101   1001
101   1001
101   1001
101   1001
101   1001
101   1001
101   1001
101   1001
101   1001
101   1001
101   1001
101   1001
101   1001
101   1001
101   1001
101   1001
101   1001
101   1001
101   1001
101   1001
101   1001
101   1001
101   1001
101   1001
101   1001
101   1001
101   1001
101   1001
101   1001
101   1001
101   1001
101   1001
101   1001
101   1001
101   1001
101   1001
101   1001
101   1001
101   1001
101   1001
101   1001
101   1001
101   1001
101   1001
101   1001
101   1001
101   1001
101   1001
101   1001
101   1001
101   1001
101   1001
101   1001
101   1001
101   1001
101   1001
101   1001
101   1001
101   1001
101   1001
101   1001
101   1001
101   1001
101   1001
101   1001
101   1001
101   1001
101   1001
101   1001
101   1001
101   1001
101   1001
101   1001
101   1001
101   1001
101   1001
101   1001
101   1001
101   1001
101   1001
101   1001
101   1001
101   1001
101   1001
101   1001
101   1001
101   1001
101   1001
101   1001
101   1001
101   1001
101   1001
101   1001
101   1001
101   1001
101   1001
101   1001
101   1001
101   1001
101   1001
101   1001
101   1001
101   1001
101   1001
101   1001
101   1001
101   1001
101   1001
101   1001
101   1001
101   1001
101   1001
101   1001
101   1001
101   1001
101   1001
101   1001
101   1001
101   1001
101   1001
101   1001
101   1001
101   1001
101   1001
101   1001
101   1001
101   1001
101   1001
101   1001
101   1001
101   1001
101   1001
101   1001
101   1001
101   1001
101   1001
101   1001
101   1001
101   1001
101   1001
101   1001
101   1001
101   1001
101   1001
101   1001
101   1001
101   1001
101   1001
101   1001
101   1001
101   1001
101   1001
101   1001
101   1001
101   1001
101   1001
101   1001
101   1001
101   1001
101   1001
101   1001
101   1001
101   1001
101   1001
101   1001
101   1001
101   1001
101   1001
101   1001
101   1001
101   1001
101   1001
101   1001
101   1001
101   1001
101   1001
101   1001
101   1001
101   1001
101   1001
101   1001
101   1001
101   1001
101   1001
101   1001
101   1001
101   1001
101   1001
101   1001
101   1001
101   1001
101   1001
101   1001
101   1001
101   1001
101   1001
101   1001
101   1001
101   1001
101   1001
101   1001
101   1001
101   1001
101   1001
101   1001
101   1001
101   1001
101   1001
101   1001
101   1001
101   1001
101   1001
101   1001
101   1001
101   1001
101   1001
101   1001
101   1001
101   1001
101   1001
101   1001
101   1001
101   1001
101   1001
101   1001
101   1001
101   1001
101   1001
101   1001
101   1001
101   1001
101   1001
101   1001
101   1001
101   1001
101   1001
101   1001
101   1001
101   1001
101   1001
101   1001
101   1001
101   1001
101   1001
101   1001
101   1001
101   1001
101   1001
101   1001
101   1001
101   1001
101   1001
101   1001
101   1001
101   1001
101   1001
101   1001
101   1001
101   1001
101   1001
101   1001
101   1001
101   1001
101   1001
101   1001
101   1001
101   1001
101   1001
101   1001
101   1001
101   1001
101   1001
101   1001
101   1001
101   1001
101   1001
101   1001
101   1001
101   1001
101   1001
101   1001
101   1001
101   1001
101   1001
101   1001
101   1001
1011111001
1000000001
100S000001
1111111111
