   NO                      ./textures/bluestone.xpm
   SO ./textures/colorstone.xpm
   WE ./textures/greystone.xpm
   EA   ./textures/redbrick.xpm
   
   F 124, 55   , 1
  
  C     12, 220, 125


11111111111111111111111111111111111
10001000101010101000101010001010101
10100010101010101010101010101000N01
10010010010000010010010010010010001
11011001010111011011001001010100101
11011111010111000011100010001001101
11011110000111111011111100100011111
11010000111111111011111101100011111
10000100000000000000000000000011111
10111110001111111011111111111111111
10000000100000000011111111111111111
11111111111111111111111111111111111
