  NO       ./textures/bluestone.xpm
  SO ./textures/colorstone.xpm
  WE ./textures/greystone.xpm
 EA   ./textures/redbrick.xpm


F 220, 100, 0
C 225, 30, 0

11111111111
10000000001
10001110001
10001110001
10001110001
10001110001
10001110001
10101110101
10101110101
10101110101
10101110101
10101110101
10101110101
10101110101
10101110101
10101110101
10101110101
10101110101
10101110101
10101110101
10101110101
10101110101
10101110101
10101110101
10101110101
10101110101
10101110101
10101110101
10101110101
10101110101
10101110101
10101110101
10101110101
10101110101
10101110101
10101110101
10101110101
10101110101
10101110101
10101110101
10101110101
10101110101
10101110101
10101110101
10101110101
10101110101
10101110101
10101110101
10101110101
10101110101
10101110101
10101110101
10101110101
10101110101
10101110101
10101110101
10101110101
10101110101
10101110101
10101110101
10101110101
10001110001
10001110001
10001110001
10001110001
10001110001
10001110001
10001110001
10001110001
10001110001
10001110001
10001110001
10001110001
10001110001
10001110001
10001110001
10001110001
10001110001
10101110101
10101110101
10101110101
10101110101
10101110101
10101110101
10101110101
10101110101
10101110101
10101110101
10101110101
10101110101
10101110101
10101110101
10101110101
10101110101
10101110101
10101110101
10101110101
10101110101
10101110101
10101110101
10101110101
10101110101
10101110101
10101110101
10101110101
10101110101
10101110101
10101110101
10101110101
10101110101
10101110101
10101110101
10101110101
10101110101
10101110101
10101110101
10101110101
10101110101
10101110101
10101110101
10101110101
10101110101
10101110101
10101110101
10101110101
10101110101
10101110101
10101110101
10101110101
10101110101
10101110101
10101110101
10101110101
10101110101
10101110101
10101110101
10101110101
10101110101
10101110101
10101110101
10101110101
10101110101
10001110001
10001110001
11001110111
11001110111
11001110111
11001110111
11001110111
11001110111
11001110111
11001110111
11001110111
11001110111
11001110111
11001110111
11001110111
11001110111
11001110111
11001110111
11001110111
11001110111
11001110111
11001110111
11001110111
11001110111
11001110111
11001110111
11001110111
11001110111
11001110111
11001110111
11001110111
11001110111
11001110111
11001110111
11001110111
11001110111
11001110111
11001110111
11001110111
11001110111
11001110111
11001110111
11001110111
11001110111
11001110111
11001110111
11001110111
11001110111
11001110111
11001110111
11001110111
11001110111
11001110111
11001110111
11001110111
11001110111
11001110111
11001110111
11001110111
11001110111
11001110111
11001110111
11001110111
11001110111
11001110111
11001110111
11001110111
11001110111
11001110111
11001110111
11001110111
11001110111
11001110111
11001110111
11001110111
11001110111
11001110111
11001110111
11001110111
11001110111
11001110111
11001110111
11001110111
11001110111
11001110111
11001110111
11001110111
11001110111
11001110111
11001110111
11001110111
11001110111
11001110111
11001110111
11001110111
11001110111
11001110111
11001110111
11001110111
11001110111
11001110111
11001110111
11001110111
11001110111
11001110111
11001110111
11001110111
11001110111
11001110111
11001110111
11001110111
11001110111
11001110111
11001110111
11001110111
11001110111
11001110111
11001110111
11001110111
11001110111
11001110111
11001110111
11001110111
11001110111
11001110111
11001110111
11001110111
11001110111
11001110111
11001110111
11001110111
11001110111
11001110111
11001110111
11001110111
11001110111
11001110111
11001110111
11001110111
11001110111
11001110111
11001110111
11001110111
11001110111
11001110111
11001110111
11001110111
11001110111
11001110111
11001110111
11001110111
11001110111
11001110111
11001110111
11001110111
11001110111
11001110111
11001110111
11001110111
11001110111
11001110111
11001110111
11001110111
11001110111
11001110111
11001110111
11001110111
11001110111
11001110111
11001110111
11001110111
11001110111
11001110111
11001110111
11001110111
11001110111
11001110111
11001110111
11001110111
11001110111
11001110111
11001110111
11001110111
11001110111
11001110111
11001110111
11001110111
11001110111
10001110001
10001110001
10001110001
10001110001
10001110001
10001110001
10001110001
10001110001
10001110001
10001110001
10001110001
10001110001
10001110001
10001110001
10001110001
10001110001
10001110001
10001110001
10001110001
10001110001
10001110001
10001110001
10001110001
10001110001
10001110001
10001110001
10001110001
10001110001
10001110001
10001110001
10001110001
10001110001
10001110001
10001110001
10001110001
10001110001
10001110001
10001110001
10001110001
10001110001
10001110001
10001110001
10001110001
10001110001
10001110001
10001110001
10001110001
10001110001
10001110001
10001110001
10001110001
10001110001
10001110001
10001110001
10001110001
10001110001
10001110001
10001110001
10001110001
10001110001
10001110001
10001110001
10001110001
10001110001
10001110001
10001110001
10001110001
10001110001
10001110001
10001110001
10001110001
10001110001
10001110001
10001110001
10001110001
10001110001
10001110001
10001110001
10001110001
10001110001
10001110001
10001110001
10001110001
10001110001
10001110001
10001110001
10001110001
10001110001
10001110001
10001110001
10001110001
10001110001
10001110001
10001110001
10001110001
10001110001
10001110001
10001110001
10001110001
10001110001
10001110001
10001110001
10001110001
10001110001
10001110001
10001110001
10001110001
10001110001
10001110001
10001110001
10001110001
10001110001
10001110001
10001110001
10001110001
10001110001
10001110001
10001110001
10001110001
10001110001
10001110001
10001110001
10001110001
10001110001
10001110001
10001110001
10001110001
10001110001
10001110001
10001110001
10001110001
10001110001
10001110001
10001110001
10001110001
10001110001
10001110001
10001110001
10001110001
10001110001
10001110001
10001110001
10001110001
10001110001
10001110001
10001110001
10001110001
10001110001
10001110001
10001110001
10001110001
10001110001
10001110001
10001110001
10001110001
10001110001
10001110001
10001110001
10001110001
10001110001
10001110001
10001110001
10001110001
10001110001
10001110001
10001110001
10001110001
10001110001
10001110001
10001110001
10001110001
10001110001
10001110001
10001110001
10001110001
10001110001
10001110001
10001110001
10001110001
10001110001
10001110001
10001110001
10001110001
10001110001
10001110001
10001110001
10001110001
10001110001
10001110001
10001110001
10001110001
10001110001
10001110001
10001110001
10001110001
10001110001
10001110001
10001110001
10001110001
10001110001
10001110001
10001110001
10001110001
10001110001
10001110001
10001110001
10001110001
10001110001
10001110001
10001110001
10001110001
10001110001
10001110001
10001110001
10001110001
10001110001
10001110001
10001110001
10001110001
10001110001
10001110001
1000N000001
11111111111
